1111111111111111111111111111111
1P000010000000100000001000000E1
1011101011111010111110101111101
1000001000000010000000100000001
1111101111101011111010111110111
1000000000101000001010000010001
1011111110101111101011111010101
1010000000100000101000001010101
1010111111111110101111101010101
1010100000000010100000101010101
1010101111111010111110101010101
1010100000001010000010101010101
1010111111101011111010101010101
1010000000101000001010101010101
1011111110101111101010101010101
1000000010100000101010101010101
1111111010111110101010101010101
1000001010000010101010101010101
1011101011111010101010101010101
1010001010001010101010101010101
1010111010101010101010101010101
1010000010101010101010101010101
1011111110101010101010101010101
1000000000101010101010101010101
1111111111101010101010101010101
1C00000000001010101010101010101
1011111111111010101010101010101
1000000000000010101010101010101
1111111111111110101010101010101
1C000000000000C0001010101010101
1111111111111111111111111111111 