11111111111111111
1E00000C000000P01
11111111111111111