111111111
1P0C0E0X1
111111111 