1111111111
1P0C0E00P1
1000000001
1111111111 