1111111111
1P00E00001
1000000001
1111111111 