1111111111
100C0E0001
1000000001
1111111111 