1111111111
1P0C0E001
10000001
1111111111 