1111111111
1P000E0001
1111111111
1000C00001
1111111111 